---P--P---
--W-------
------P---
-----P----
---G------
W-----P---
--P-------
P------W--
---P--P---
-----P----