---P--P---
--W-------
--G---P---
-----P--W-
----------
--W---P---
----------
PP-P---W--
---P--P---
---P------